Bitcoin — BTC

Ethereum — ETH

Tether USDt — USDT

XRP — XRP

BNB — BNB

Solana — SOL

USD Coin — USDC

Dogecoin — DOGE

Cardano — ADA

TRON — TRX

Hyperliquid — HYPE

Sui — SUI

Chainlink — LINK

Avalanche — AVAX

Stellar — XLM

Shiba Inu — SHIB

Bitcoin Cash — BCH

UNUS SED LEO — LEO

Hedera — HBAR

Toncoin — TON

Litecoin — LTC

Polkadot — DOT

Monero — XMR

Bitget Token — BGB

Pepe — PEPE

Pi Network — PI

Dai — DAI

Ethena (USDe) — USDe

Aave — AAVE

Uniswap — UNI

Bittensor — TAO

NEAR Protocol — NEAR

Aptos — APT

OKB — OKB

Ondo — ONDO

Ethereum Classic — ETC

Internet Computer — ICP

Kaspa — KAS

Cronos — CRO

Official TRUMP — TRUMP

GateToken — GT

Render — RENDER

Mantle — MNT

VeChain — VET

Pol (prev. MATIC) — POL

Ethena — ENA

Artificial Superintelligence Alliance — FET

Worldcoin — WLD

World Liberty Financial USD — USD1

Arbitrum — ARB